{
  "stampId": "castle_floor1",
  "label": "Castle Second Floor",
  "rows": [
    "CWWWWWWWWWWWWWWWWWWWWWWWWWWWWWC",
    "WFFFFFFFFFFFFFFFFFFFFFFFFFFFFFW",
    "WFFFFFFFFFFFFFFFFFFFFFFFFFFFFFW",
    "WFFFFFFFFFFFFFFFFFFFFFFFFFFFFFW",
    "WFFFFFFFFFFFFFFFFFFFFFFFFFFFFFW",
    "WFFFFFFFFFFFFFFFFFFFFFFFFFFFFFW",
    "WFFFFFFFFFFFFFFFFFFFFFFFFFFFFFW",
    "WFFFFFCWWWWWWWFFFFWWWWWWCFFFFFW",
    "WFFFFFWFFFFFFFFFFFFFFFFFWFFFFFW",
    "WFFFFFWFFFFFFFFFFFFFFFFFWFFFFFW",
    "WFFFFFWFFFFFFFFFFFFFFFFFWFFFFFW",
    "WFFFFFWFFFFFFFFKFFFQFFFFWFFFFFW",
    "WFFFFFWFFFFFFFFFFFFFFFFFWFFFFFW",
    "WFFFFFWFFFFFFFFFFFFFFFFFWFFFFFW",
    "WFFFFFWFFFFFFFFFFFFFFFFFWFFFFFW",
    "WFFFFFWFFFFFFFFFFFFFFFFFWFFFFFW",
    "WFFFFFWFFFFFFFFFFFFFFFFFWFFFFFW",
    "WFFFFFCWWWWWWWFFFFWWWWWWCFFFFFW",
    "WFFFFFFFFFFFFFFFFFFFFFFFFFFFFFW",
    "WFFFFFFFFFFFFFFFFFFFFFFFFFFFFFW",
    "WFFFFFFFFFFFFFFFFFFFFFFFFFFFFFW",
    "WFFFFFFFFFFFFFFFFFFFFFFFFFFFFFW",
    "WFFFFFFFFFFFFFFFFFFFFFFFFFFFFFW",
    "WFFFFFFFFFFFFFFFFFFFFFFFFFFFFFW",
    "WFFFFFFFFFFFFFFFFFFFFFFFFFFFFFW",
    "CWWWWWWWWWWWWWWWWWWWWWWWWWWWWWC"
  ]
}
