{
  "stampId": "castle_floor0",
  "label": "Castle Ground Floor",
  "rows": [
    "CWWWWWWWWWWWWWWWWWWWWWWWWWWWWWC",
    "WFFFFFFFFFFFFFFFFFFFFFFFFFFFFFW",
    "WFFFFFFFFFFFFFFFFFFFFFFFFFFFFFW",
    "WFFFFFFFFFFFFFFFFFFFFFFFFFFFFFW",
    "WFFFFFFFFFFFFFFFFFFFFFFFFFFFFFW",
    "WFFFFFFFFFFFFFFFFFFFFFFFFFFFFFW",
    "WFFFFFFFFFFFFFFFFFFFFFFFFFFFFFW",
    "WFFFFFCWWWWWWWFFFFWWWWWWCFFFFFW",
    "WFFFFFWFFFFFFFFFFFFFFFFFWFFFFFW",
    "WFFFFFWFFFFFFFFFFFFFFFFFWFFFFFW",
    "WFFFFFWFFFFFNNNNNNNFFFFFWFFFFFW",
    "WFFFFFWFFFFFBBBBBBBFFFFFWFFFFFW",
    "WFFFFFWFFFFFFFFFFFFFFFFFWFFFFFW",
    "WFFFFFWFFFFFFFFFFFFFFFFFWFFFFFW",
    "WFFFFFWFFFFFFFFFFFFFFFFFWFFFFFW",
    "WFFFFFWFFFFFFFFTFFFFFFFFWFFFFFW",
    "WFFFFFWFFFFFFFFFFFFFFFFFWFFFFFW",
    "WFFFFFCWWWWWWWFFFFWWWWWWCFFFFFW",
    "WFFFFFFFFFFFFFFFFFFFFFFFFFFFFFW",
    "WFFFFFFFFFFFFFFFFFFFFFFFFFFFFFW",
    "WFFFFFFFFFFFFFFFFFFFFFFFFFFFFFW",
    "WFFFFFFFFFFFFFFFFFFFFFFFFFFFFFW",
    "WFFFFFFFFFFFFFFFFFFFFFFFFFFFFFW",
    "WFFFFFFFFFFFFFFFFFFFFFFFFFFFFFW",
    "WFFFFFFFFFFFFFFFFFFFFFFFFFFFFFW",
    "CWWWWWWWWWWWWWWsssWWWWWWWWWWWWC"
  ]
}
